2;2;2;2;2;2;2;2;2;2;2;2;2;2;2;2;2;2;2;2
2;0;0;0;0;0;0;2;2;2;2;0;0;0;0;0;0;0;0;2
2;0;0;1;1;1;0;2;2;2;2;0;0;0;0;0;0;0;0;2
2;0;0;1;1;1;0;2;2;2;2;0;0;0;0;0;0;0;0;2
2;0;0;0;0;0;0;0;0;0;2;0;0;0;0;0;0;0;0;2
2;0;6;6;6;7;7;0;0;0;2;0;0;0;0;0;0;0;0;2
2;0;0;0;0;0;0;0;0;0;2;0;0;0;0;0;0;0;0;2
2;0;0;0;0;0;0;0;0;0;2;0;0;0;0;0;0;0;0;2
2;0;0;4.1;0;0;0;0;0;0;5.1.1;0;0;0;0;0;0;0;0;3
2;0;0;0;0;0;0;0;0;0;2;0;0;0;0;0;0;0;0;3
2;0;0;0;0;0;0;0;0;0;2;0;0;0;0;0;0;0;0;2
2;0;0;0;0;0;0;0;0;0;3;0;0;0;0;0;0;0;0;2
2;0;0;8;0;9;0;10;0;0;3;0;0;0;0;0;0;0;0;2
2;0;0;0;0;0;0;0;0;0;3;0;0;0;0;0;0;0;0;2
2;0;0;0;0;3;0;0;0;0;3;0;0;0;0;0;0;0;0;2
2;0;0;0;0;0;0;0;0;0;3;0;0;0;0;0;0;0;0;2
2;0;0;0;0;0;0;0;0;0;3;0;0;0;0;0;0;0;0;2
2;0;0;0;0;0;0;0;0;0;3;0;0;0;0;0;0;0;0;2
2;0;0;0;0;0;0;0;0;0;2;0;0;0;0;0;0;0;0;2
2;2;2;2;2;2;2;2;2;2;2;2;2;2;2;2;2;2;2;2
